11111
10001
1000
10001
10001
11111