11111
1E0C1
10001
10001
1P001
11111