11111
1EPC1
10001
10001
10001
11111