1111111
1E0C1C1
10C0101
10000C1
1P00001
1111111